4,4,4,4,4,4,4,4,4,4,4,
4,1,1,1,1,1,1,1,1,1,1,
4,1,3,2,1,2,2,1,2,3,1,
4,1,2,2,1,2,2,1,2,2,1,
4,1,1,1,5,2,2,5,1,1,1,
4,1,2,6,2,1,1,2,6,2,1,
4,1,2,6,2,1,1,2,6,2,1,
4,1,1,1,5,2,2,5,1,1,1,
4,1,2,2,1,2,2,1,2,2,1,
4,1,3,2,1,2,2,1,2,3,1,
4,1,0,1,1,1,1,1,1,1,1,
