4,4,4,4,4,4,4,4,4,4,4,
4,2,2,2,1,1,1,1,2,2,2,
4,2,6,1,1,2,2,1,1,6,2,
4,2,1,1,2,1,1,2,1,1,2,
4,1,1,2,1,3,5,1,2,1,1,
4,1,1,2,1,5,3,1,2,1,1,
4,2,1,1,2,1,1,2,1,1,2,
4,2,2,1,1,2,2,1,1,2,2,
4,2,2,2,1,2,1,1,2,2,2,
4,2,6,2,2,1,1,2,2,6,2,
4,2,2,2,1,0,1,1,2,2,2,
