4,4,4,4,4,4,4,4,4,4,4,
4,0,3,2,2,2,2,2,2,2,2,
4,1,3,1,1,6,1,1,5,1,1,
4,2,2,2,2,2,2,2,5,2,2,
4,1,1,3,1,1,6,1,1,5,1,
4,2,2,2,2,2,2,2,2,2,2,
4,5,1,1,3,1,1,6,1,1,5,
4,2,2,2,2,2,2,2,2,2,2,
4,1,5,1,1,3,1,1,6,1,1,
4,2,2,2,2,2,2,2,2,2,2,
4,1,1,5,1,1,3,1,1,6,1,
