4,4,4,4,4,4,4,4,4,4,4,
4,3,1,1,3,1,1,3,1,1,3,
4,1,2,1,6,1,1,6,1,1,1,
4,1,2,5,5,1,1,1,1,1,1,
4,3,2,5,2,1,1,1,1,1,3,
4,2,1,1,1,3,1,1,1,1,1,
4,2,1,1,1,2,1,1,5,1,1,
4,3,1,1,1,1,1,1,5,1,3,
4,1,1,1,1,1,1,1,1,1,1,
4,0,1,1,6,1,1,6,1,1,1,
4,3,1,1,3,1,1,3,1,1,3,
