4,4,4,4,4,4,4,4,4,4,4,
4,1,1,1,1,1,1,1,1,5,5,
4,1,7,1,1,1,1,1,1,5,1,
4,1,1,6,1,1,1,1,6,1,2,
4,1,1,1,2,2,2,2,1,1,2,
4,1,1,1,2,1,1,2,1,1,2,
4,1,1,1,2,1,1,2,1,1,2,
4,1,1,1,2,2,2,2,1,1,2,
4,1,1,6,1,7,1,1,6,1,3,
4,2,2,1,1,1,1,1,1,1,0,
4,2,2,5,5,1,1,1,1,2,3,
